6 10
|--------|
|..f|....|
|...|....|
|.p...@|.|
|..p...|.|
|--------|